LED display, LED displays	lysdiodskärm, lysdiodskärmen, lysdiodskärmar	N
LED, LEDs	lysdiod, lysdioden, lysdioder	N
abstract	abstrakt, abstrakt, abstrakta	A
abstract data type, abstract data types	abstrakt datatyp, abstrakta datatypen, abstrakta datatyper	N
abstract method, abstract methods	abstrakt metod, abstrakta metoden, abstrakta metodar	N
abstract, abstracts	utdrag, utdraget, utdrag	N
abstraction, abstractions	abstraktion, abstraktionen, abstraktioner	N
accelerate, accelerated, accelerated	 accelerera, accelererade, accelererat	V
acceleration, accelerations	acceleration, accelerationen, accelerationer	N
accelerator, accelerators	accelerator, acceleratorn, acceleratorer	N
accept, accepted, accepted	 acceptera, accepterade, accepterat	V
acceptance, acceptances	godkännande, godkännandet, godkännanden	N
access control, access controls	åtkomstkontroll, åtkomstkontrollen, åtkomstkontroller	N
access, accesses	åtkomst, åtkomsten, åtkomster	N
accessibility, accessibilities	tillgänglighet, tillgängligheten, tillgängligheter	N
accompany, accompanied, accompanied	 medfölja, medföljde, medföljt	V
account, accounts	konto, kontot, konton	N
accounting software, accounting softwares	bokföringsprogram, bokföringsprogrammet, bokföringsprogram	N
accumulator, accumulators	ackumulator, ackumulatorn, ackumulatorer	N
accuracy, accuracies	noggrannhet, noggrannheten, noggrannheter	N
achieve, achieved, achieved	 uppnå, uppnådde, uppnått	V
acknowledge, acknowledged, acknowledged	 erkänna, erkände, erkänt	V
acoustic	akustisk, akustiskt, akustiska	A
acoustic, acoustics	akustik, akustiken, akustiker	N
acronym, acronyms	akronym, akronymen, akronymer	N
act, acted, acted	 agera, agerade, agerat	V
act, acts	handling, handlingen, handlingar	N
action, actions	handling, handlingen, handlingar	N
activation, activations	aktivering, aktiveringen, aktiveringar	N
active	aktiv, aktivt, aktiva	A
actor, actors	skådespelare, skådespelaren, skådespelare	N
ad, ads	reklam, reklamen, reklamer	N
adaptation, adaptations	anpassning, anpassningen, anpassningar	N
adapter, adapters	adapter, adaptern, adaptrar	N
adaptive	adaptiv, adaptivt, adaptiva	A
additional	ytterligare, ytterligare, ytterligare	A
address space, address spaces	adressrymd, adressrymden, adressrymder	N
address, addressed, addressed	 adressera, adresserade, adresserat	V
address, addresses	adress, adressen, adresser	N
administrative	administrativ, administrativt, administrativa	A
admission requirement, admission requirements	tillträdeskrav, tillträdeskravet, tillträdeskrav	N
advance, advanced, advanced	 avancera, avancerade, avancerat	V
advance, advances	framsteg, framsteget, framsteg	N
affect, affected, affected	 påverka, påverkade, påverkat	V
agency, agencys	byrå, byrån, byråer	N
agent, agents	agent, agenten, agenter	N
aggregation, aggregations	aggregation, aggregationen, aggregationer	N
agile	agil, agilt, agila	A
agile software development, agile software developments	agil mjukvaruutveckling, agila mjukvaruutvecklingen, agila mjukvaruutvecklingar	N
agreement, agreements	avtal, avtalet, avtal	N
aid, aided, aided	 hjälpa, hjälpte, hjälpt	V
aim, aimed, aimed	 syfta, syftade, syftat	V
aim, aims	syfte, syftet, syften	N
airflow, airflows	luftflöde, luftflödet, luftflöden	N
algebra, algebras	algebra, algebran, algebror	N
algebraic	algebraisk, algebraiskt, algebraiska	A
algorithm analysis, algorithm analyses	algoritmanalys, algoritmanalysen, algoritmanalyser	N
algorithm design techniques, algorithm design techniqueses	algoritmdesigntekniker, algoritmdesignteknikret, algoritmdesigntekniker	N
algorithm design, algorithm designs	algoritmdesign, algoritmdesignen, algoritmdesigner	N
algorithm, algorithms	algoritm, algoritmen, algoritmer	N
algorithmic	algoritmisk, algoritmiskt, algoritmiska	A
alliance, alliances	förbund, förbundet, förbund	N
allocation, allocations	fördelning, fördelningen, fördelningar	N
allow, allowed, allowed	 låta, lät, låtit	V
alternate, alternated, alternated	 växla, växlade, växlat	V
amplitude, amplitudes	amplitud, amplituden, amplituder	N
analyse, analysed, analysed	 analysera, analyserade, analyserat	V
analysis, analysises	analys, analysen, analyser	N
analytical	analytisk, analytiskt, analytiska	A
anisotropic	anisotrop, anisotropt, anisotropa	A
answer, answers	svar, svaret, svar	N
antenna, antennas	antenn, antennen, antenner	N
antibiotic, antibiotics	antibiotikum, antibiotikumet, antibiotika	N
antivirus, antiviruses	antivirus, antiviruset, antivirus	N
appliance, appliances	tillämpning, tillämpningen, tillämpningar	N
application software, application softwares	tillämpningsprogram, tillämpningsprogramet, tillämpningsprogram	N
application, applications	applikation, applikationen, applikationer	N
applied data science, applied data sciences	applicerad datavetenskap, applicerade datavetenskapen, applicerade datavetenskaper	N
apply, applied, applied	 applicera, applicerade, applicerat	V
appropriate, appropriated, appropriated	 bestämma, bestämde, bestämt	V
approximate, approximated, approximated	 approximera, approximerade, approximerat	V
approximation, approximations	approximation, approximationen, approximationer	N
architect, architects	arkitekt, arkitekten, arkitekter	N
architectural	arkitekturell, arkitekturellt, arkitekturella	A
architecture, architectures	arkitektur, arkitekturen, arkitekturer	N
argue, argued, argued	 argumentera, argumenterade, argumenterat	V
argument, arguments	argument, argumentet, argument	N
arithmetic, arithmetics	aritmetik, aritmetiken, aritmetiker	N
array, arrays	fält, fältet, fält	N
arrival, arrivals	ankomst, ankomsten, ankomster	N
article, articles	artikel, artikeln, artiklar	N
articulate, articulated, articulated	 artikulera, artikulerade, artikulerat	V
artificial	artificiell, artificiellt, artificiella	A
artificial intelligence, artificial intelligences	artificiell intelligens, artificiella intelligensen, artificiella intelligenser	N
aspect, aspects	aspekt, aspekten, aspekter	N
assembly code, assembly codes	assemblykod, assemblykoden, assemblykoder	N
assembly programming, assembly programmings	assemblerprogrammering, assemblerprogrammeringen, assemblerprogrammeringar	N
assembly, assemblies	assembly, assemblyn, assemblys	N
assess, assessed, assessed	 bedöma, bedömde, bedömt	V
assessment, assessments	bedömning, bedömningen, bedömningar	N
assign, assigned, assigned	 tilldela, tilldelade, tilldelat	V
assignment, assignments	inlämningsuppgift, inlämningsuppgiften, inlämningsuppgifter	N
assist, assisted, assisted	 hjälpa, hjälpte, hjälpt	V
assistant, assistants	assistent, assistenten, assistenter	N
associate, associated, associated	 associera, associerade, associerat	V
association, associations	samband, sambandet, samband	N
associative	associativ, associativt, associativa	A
assume, assumed, assumed	 anta, antog, antagit	V
asymmetric	asymmetrisk, asymmetriskt, asymmetriska	A
asymptotic	asymptotisk, asymptotiskt, asymptotiska	A
asynchronous	asynkron, asynkront, asynkrona	A
attachment, attachments	bilaga, bilagan, bilagor	N
attack model, attack models	attackmodell, attackmodellen, attackmodeller	N
attack, attacked, attacked	 angripa, angrep, angripit	V
attack, attacks	attack, attacken, attacker	N
attenuation, attenuations	försvagning, försvagningen, försvagningar	N
attribute, attributes	attribut, attributet, attribut	N
audio, audios	ljud, ljudet, ljud	N
authentication, authentications	autentisering, autentiseringen, autentiseringar	N
authore, authored, authored	 författa, författade, författat	V
authority, authorities	myndighet, myndigheten, myndigheter	N
automata theory, automata theories	automatteori, automatteorien, automatteoriar	N
automate, automated, automated	 automatisera, automatiserade, automatiserat	V
automated	automatiserad, automatiserat, automatiserade	A
automation, automations	automatisering, automatiseringen, automatiseringar	N
automaton, automata	automat, automaten, automater	N
autonomous	självstyrande, självstyrande, självstyrande	A
availability, availabilities	tillgång, tillgången, tillgångar	N
available	tillgänglig, tillgängligt, tillgängliga	A
average	genomsnittlig, genomsnittligt, genomsnittliga	A
average, averages	genomsnitt, genomsnittet, genomsnitt	N
axial	axial, axialt, axiala	A
bachelor, bachelors	kandidat, kandidaten, kandidater	N
background, backgrounds	bakgrund, bakgrunden, bakgrunder	N
balance, balanced, balanced	 balansera, balanserade, balanserat	V
bandwidth, bandwidths	bandbredd, bandbredden, bandbredder	N
base, based, based	 basera, baserade, baserat	V
basic	grundläggande, grundläggande, grundläggande	A
basic principle, basic principles	grundprincip, grundprincipen, grundprinciper	N
basic, basics	grund, grunden, grunder	N
batch, batches	batch, batchen, batcher	N
baud, bauds	baud, baudet, baud	N
begin, began, begun	 börja, började, börjat	V
behavior, behaviors	beteende, beteendet, beteenden	N
behaviour, behaviours	beteende, beteendet, beteenden	N
benchmark, benchmarks	riktvärde, riktvärdet, riktvärden	N
bidirectional	dubbelriktad, dubbelriktat, dubbelriktade	A
big data, big data	stor data, stora datan, stora data	N
binary	binär, binärt, binära	A
binary number, binary numbers	binärt tal, binära talet, binära tal	N
binary search algorithm, binary search algorithms	binärsökning, binärsökningen, binärsökningar	N
binary search tree, binary search trees	binärt sökträd, binära sökträdet, binära sökträd	N
binary tree, binary trees	binärträd, binärträdet, binärträd	N
bind, bound, bound	 binda, band, bundit	V
bioinformatics, bioinformatics	bioinformatik, bioinformatiken, bioinformatiker	N
biology, biologies	biologi, biologin, biologier	N
bios, bioses	bios, bioset, bios	N
bipolar	bipolär, bipolärt, bipolära	A
bit rate, bit rates	överföringskapacitet, överföringskapaciteten, överföringskapaciteter	N
bit, bits	bit, biten, bitar	N
bitrate, bitrates	bithastighet, bithastigheten, bithastigheter	N
blacklist, blacklists	svartlista, svartlistan, svartlistor	N
block, blocked, blocked	 hindra, hindrade, hindrat	V
block, blocks	block, blocket, block	N
blueprint, blueprints	blåkopia, blåkopian, blåkopior	N
bluetooth, bluetooths	blåtand, blåtanden, blåtänder	N
book, booked, booked	 boka, bokade, bokat	V
boolean	boolesk, booleskt, booleska	A
boolean data type, boolean data types	boolesk datatyp, booleska datatypen, booleska datatyper	N
boot, booted, booted	 ladda, laddade, laddat	V
border, bordered, bordered	 gränsa, gränsade, gränsat	V
border, borders	gräns, gränsen, gränser	N
bot, bots	bot, boten, botar	N
bottleneck, bottlenecks	flaskhals, flaskhalsen, flaskhalsar	N
bound, bounded, bounded	 gränsa, gränsade, gränsat	V
boundary, boundarys	gräns, gränsen, gränser	N
branch, branched, branched	 grena, grenade, grenat	V
branch, branches	gren, grenen, grenar	N
breadth, breadths	bredd, bredden, bredder	N
bridge, bridges	brygga, bryggan, bryggor	N
broker, brokers	agent, agenten, agenter	N
bug, bugs	bugg, buggen, buggar	N
build, built, built	 bygga, byggde, byggt	V
bulletin, bulletins	rapport, rapporten, rapporter	N
bus, buses	buss, bussen, bussar	N
business information system, business information systems	affärsinformationssystem, affärsinformationssystemet, affärsinformationssystem	N
business, businesses	företag, företaget, företag	N
byte, bytes	byte, byten, bytes	N
cable, cables	kabel, kabeln, kablar	N
cache memory, cache memories	cacheminne, cacheminnet, cacheminnen	N
cache, cached, cached	 gömma, gömde, gömt	V
cache, caches	cache, cachet, cachen	N
calculation, calculations	beräkning, beräkningen, beräkningar	N
calculator, calculators	miniräknare, miniräknaren, miniräknare	N
calculus, calculuss	analys, analysen, analyser	N
call, called, called	 anropa, anropade, anropat	V
call, called, called	 kalla, kallade, kallat	V
call, calls	krav, kravet, krav	N
camera, cameras	kamera, kameran, kameror	N
capability, capabilities	kompetens, kompetensen, kompetenser	N
capacity, capacities	kapacitet, kapaciteten, kapaciteter	N
capsule, capsules	kapsel, kapseln, kapslar	N
captcha, captchas	captcha, captchat, captchas	N
capture, captured, captured	 fånga, fångade, fångat	V
card reader, card readers	kortläsare, kortläsaren, kortläsare	N
card, cards	kort, kortet, kort	N
carriage, carriages	vagn, vagnen, vagnar	N
carrier, carriers	bärare, bäraren, bärare	N
cartridge, cartridges	patron, patronen, patroner	N
cassette, cassettes	kassett, kassetten, kassetter	N
categorical	kategorisk, kategoriskt, kategoriska	A
category, categorys	kategori, kategorin, kategorier	N
cathode, cathodes	katod, katoden, katoder	N
cell, cells	cell, cellen, celler	N
central, centrals	central, centralen, centraler	N
challenge, challenged, challenged	 utmana, utmanade, utmanat	V
challenge, challenges	utmaning, utmaningen, utmaningar	N
change, changed, changed	 ändra, ändrade, ändrat	V
channel, channels	kanal, kanalen, kanaler	N
character, characters	karaktär, karaktären, karaktärer	N
characteristic	karaktäristisk, karaktäristiskt, karaktäristiska	A
chat, chats	prat, pratet, prat	N
chat, chatted, chatted	 chatta, chattade, chattat	V
check, checked, checked	 kontrollera, kontrollerade, kontrollerat	V
check, checks	test, testen, tester	N
chip, chips	chip, chipet, chips	N
cipher, ciphers	chiffer, chiffret, chiffer	N
circuit structure, circuit structures	kretsstruktur, kretsstrukturen, kretsstrukturer	N
circuit, circuits	krets, kretsen, kretsar	N
class diagram, class diagrams	klassmodell, klassmodellen, klassmodeller	N
class, classs	klass, klassen, klasser	N
classification, classifications	klassificering, klassificeringen, klassificeringar	N
classifier, classifiers	klassificerare, klassificeraren, klassificerare	N
classless	klasslös, klasslöst, klasslösa	A
classroom, classrooms	klassrum, klassrummet, klassrum	N
click, clicked, clicked	 klicka, klickade, klickat	V
client, clients	klient, klienten, klienter	N
clock, clocked, clocked	 klocka, klockade, klockat	V
clock, clocks	klocka, klockan, klockor	N
close, closed, closed	 stänga, stängde, stängt	V
closure, closures	hölje, höljet, höljen	N
cloud computing, cloud computings	datormoln, datormolnen, datormolnar	N
cloud, clouds	moln, molnet, moln	N
cluster, clusters	kluster, klustret, kluster	N
code development tool, code development tools	kodutvecklingsverktyg, kodutvecklingsverktyget, kodutvecklingsverktyg	N
code generator, code generators	kodgenerator, kodgeneratorn, kodgeneratorer	N
code, coded, coded	 koda, kodade, kodat	V
code, codes	kod, koden, koder	N
coding theory, coding theories	kodningsteori, kodningsteorien, kodningsteorier	N
cognitive science, cognitive sciences	kognitionsvetenskap, kognitionsvetenskapen, kognitionsvetenskaper	N
coherency, coherencies	sammanhang, sammanhanget, sammanhang	N
collection, collections	samling, samlingen, samlingar	N
collision, collisions	kollision, kollisionen, kollisioner	N
colour, colours	färg, färgen, färger	N
column, columns	kolumn, kolumnen, kolumner	N
combinatorial	kombinatorisk, kombinatoriskt, kombinatoriska	A
comma, commas	komma, kommat, komman	N
command, commanded, commanded	 kräva, krävde, krävt	V
command, commands	kommando, kommandot, kommandon	N
command-line interpreter, command-line interpreters	kommandotolk, kommandotolken, kommandotolkar	N
comment, comments	kommentar, kommentaren, kommentarer	N
commercial	kommersiell, kommersiellt, kommersiella	A
commercial, commercials	reklamfilm, reklamfilmen, reklamfilmer	N
commission, commissions	kommission, kommissionen, kommissioner	N
common	vanlig, vanligt, vanliga	A
communicate, communicated, communicated	 kommunicera, kommunicerade, kommunicerat	V
communication system, communication systems	kommunikationssystem, kommunikationssystemet, kommunikationssystem	N
communication, communications	kommunikation, kommunikationen, kommunikationer	N
communications protocol, communications protocols	kommunikationsprotokoll, kommunikationsprotokollet, kommunikationsprotokoll	N
community, communities	grupp, gruppen, grupper	N
comparable	jämförbar, jämförbart, jämförbara	A
comparison, comparisons	jämförelse, jämförelsen, jämförelser	N
compatibility, compatibilities	förenlighet, förenligheten, förenligheter	N
compatible	kompatibel, kompatibelt, kompatibla	A
compilation, compilations	kompilering, kompileringen, kompileringar	N
compile, compiled, compiled	 kompilera, kompilerade, kompilerat	V
compiler construction, compiler constructions	kompilatorkonstruktion, kompilatorkonstruktionen, kompilatorkonstruktioner	N
compiler techniques, compiler techniqueses	kompilatortekniker, kompilatorteknikret, kompilatortekniker	N
compiler, compilers	kompilator, kompilatorn, kompilatorer	N
complement, complemented, complemented	 komplettera, kompletterade, kompletterat	V
complete, completed, completed	 avsluta, avslutade, avslutat	V
completion, completions	komplettering, kompletteringen, kompletteringar	N
complex	komplex, komplext, komplexa	A
complex, complexes	komplex, komplexet, komplex	N
complexity analysis, complexity analyses	komplexitetsanalys, komplexitetsanalysen, komplexitetsanalyser	N
complexity, complexities	komplexitet, komplexiteten, komplexiteter	N
component	tillhörande, tillhörande, tillhörande	A
component, components	komponent, komponenten, komponenter	N
compose, composed, composed	 komponera, komponerade, komponerat	V
composition, compositions	komposition, kompositionen, kompositioner	N
comprehend, comprehended, comprehended	 begripa, begrep, begripit	V
compulsory	obligatorisk, obligatoriskt, obligatoriska	A
computability theory, computability theories	beräkningsteori, beräkningsteorin, beräkningsteorier	N
computable	beräkningsbar, beräkningsbart, beräkningsbara	A
computation, computations	beräkning, beräkningen, beräkningar	N
computational	beräkningsmässig, beräkningsmässigt, beräkningsmässiga	A
computational biology, computational biologies	beräkningsbiologi, beräkningsbiologien, beräkningsbiologier	N
computational chemistry, computational chemistries	beräkningskemi, beräkningskemien, beräkningskemier	N
computational physics, computational physics	beräkningsfysik, beräkningsfysiken, beräkningsfysiker	N
compute, computed, computed	 beräkna, beräknade, beräknat	V
computer architecture, computer architectures	datorarkitektur, datorarkitekturen, datorarkitekturer	N
computer case, computer cases	datorchassi, datorchassit, datorchassin	N
computer construction, computer constructions	datorkonstruktion, datorkonstruktionen, datorkonstruktioner	N
computer data storage, computer data storages	datorminne, datorminnet, datorminnen	N
computer engineering, computer engineerings	datateknik, datatekniken, datatekniker	N
computer graphics, computer graphics	datorgrafik, datorgrafiken, datorgrafiker	N
computer interaction, computer interactions	datorinteraktion, datorinteraktionen, datorinteraktioner	N
computer mouse, computer mice	datormus, datormuset, datormöss	N
computer network, computer networks	datornätverk, datornätverket, datornätverk	N
computer program, computer programs	datorprogram, datorprogrammet, datorprogram	N
computer science, computer sciences	datavetenskap, datavetenskapen, datavetenskaper	N
computer scientist, computer scientists	datalog, datalogen, dataloger	N
computer security model, computer security models	datasäkerhetsmodell, datasäkerhetsmodellen, datasäkerhetsmodeller	N
computer security, computer securities	datasäkerhet, datasäkerhetet, datasäkerhet	N
computer system architecture, computer system architectures	datorsystemarkitektur, datorsystemarkitekturen, datorsystemarkitekturer	N
computer system component, computer system components	datorsystemkomponent, datorsystemkomponenten, datorsystemkomponenter	N
computer system, computer systems	datorsystem, datorsystemet, datorsystem	N
computer terminal, computer terminals	datorterminal, datorterminalen, datorterminalar	N
computer vision, computer visions	datorseende, datorseendet, datorseenden	N
computer, computers	dator, datorn, datorer	N
computing capacity, computing capacities	beräkningskapacitet, beräkningskapaciteten, beräkningskapaciteter	N
concatenation, concatenations	konkatenering, konkateneringet, konkatenering	N
concept, concepts	koncept, konceptet, koncept	N
conceptual	begreppsmässig, begreppsmässigt, begreppsmässiga	A
conceptualization, conceptualizations	begreppsmässighet, begreppsmässigheten, begreppsmässigheter	N
concrete	konkret, konkret, konkreta	A
concurrency, concurrencies	samtidighet, samtidigheten, samtidigheter	N
concurrent	samverkande, samverkande, samverkande	A
condition, conditions	villkor, villkoret, villkor	N
conditional	villkorlig, villkorligt, villkorliga	A
conference, conferences	konferens, konferensen, konferenser	N
confidential information, confidential informations	konfidentiell information, konfidentiella informationen, konfidentiella informationer	N
configuration, configurations	konfiguration, konfigurationen, konfigurationer	N
congestion control, congestion controls	stockningskontroll, stockningskontrollen, stockningskontroller	N
congestion, congestions	stockning, stockningen, stockningar	N
congress, congresses	kongress, kongressen, kongresser	N
conjunction, conjunctions	konjunktion, konjunktionen, konjunktioner	N
connect, connected, connected	 ansluta, anslöt, anslutit	V
connection, connections	anslutning, anslutningen, anslutningar	N
connector, connectors	kopplingsdon, kopplingsdonet, kopplingsdon	N
conquer, conquered, conquered	 erövra, erövrade, erövrat	V
consistent	konsekvent, konsekvent, konsekventa	A
console, consoles	konsol, konsolen, konsoller	N
constant	konstant, konstant, konstanta	A
constant, constants	konstant, konstanten, konstanter	N
constrain, constrained, constrained	 begränsa, begränsade, begränsat	V
constraint, constraints	begränsning, begränsningen, begränsningar	N
construct, constructed, constructed	 konstruera, konstruerade, konstruerat	V
construction, constructions	konstruktion, konstruktionen, konstruktioner	N
constructor, constructors	konstruktor, konstruktorn, konstruktorer	N
consumer, consumers	konsument, konsumenten, konsumenter	N
consumption, consumptions	konsumption, konsumptionen, konsumptioner	N
container, containers	behållare, behållaren, behållare	N
content, contents	innehåll, innehållet, innehåll	N
context, contexts	kontext, kontexten, kontexter	N
context-free	kontextfri, kontextfritt, kontextfria	A
continual	ständig, ständigt, ständiga	A
continuation, continuations	fortsättning, fortsättningen, fortsättningar	N
continuity, continuities	kontinuitet, kontinuiteten, kontinuiteter	N
continuous	kontinuerlig, kontinuerligt, kontinuerliga	A
contravariance, contravariances	kontravarians, kontravariansen, kontravarianser	N
control flow, control flows	programflöde, programflödet, programflöden	N
control system, control systems	styrsystem, styrsystemet, styrsystem	N
control unit, control units	styrenhet, styrenheten, styrenheter	N
control, controlled, controlled	 kontrollera, kontrollerade, kontrollerat	V
control, controls	kontroll, kontrollen, kontroller	N
controller, controllers	kontrollant, kontrollanten, kontrollanter	N
convention, conventions	konvention, konventionen, konventioner	N
convergence, convergences	konvergens, konvergensen, konvergenser	N
convert, converted, converted	 omvandla, omvandlade, omvandlat	V
converter, converters	konverterare, konverteraren, konverterare	N
cooling, coolings	kylning, kylningen, kylningar	N
cooperative	samverkande, samverkande, samverkande	A
coordinate, coordinated, coordinated	 samordna, samordnade, samordnat	V
copy, copied, copied	 kopiera, kopierade, kopierat	V
copyright, copyrights	upphovsrätt, upphovsrätten, upphovsrätter	N
core memory, core memories	kärnminne, kärnminnet, kärnminnen	N
core, cores	kärna, kärnan, kärnor	N
corporation, corporations	bolag, bolaget, bolag	N
correction, corrections	rättelse, rättelsen, rättelser	N
correctness, correctnesses	korrekthet, korrekthetet, korrekthet	N
cost, costs	kostnad, kostnaden, kostnader	N
countermeasure, countermeasures	motåtgärd, motåtgärden, motårgärder	N
coupler, couplers	koppling, kopplingen, kopplingar	N
course plan, course plans	kursplan, kursplanen, kursplaner	N
course, courses	kurs, kursen, kurser	N
covariance, covariances	kovarians, kovariansen, kovarianser	N
create, created, created	 skapa, skapade, skapat	V
creativity, creativities	kreativitet, kreativiteten, kreativiteter	N
cross, crosses	kors, korset, kors	N
crosstalk, crosstalks	överhörning, överhörningen, överhörningar	N
cryptanalysis, cryptanalysises	kryptanalys, kryptanalysen, kryptanalyser	N
cryptography, cryptographies	kryptografi, kryptografin, kryptografier	N
cryptology, cryptologys	kryptologi, kryptologin, kryptologier	N
crystal, crystals	kristall, kristallen, kristaller	N
current	nuvarande, nuvarande, nuvarande	A
current, currents	ström, strömmen, strömmar	N
curve, curved, curved	 svänga, svängde, svängt	V
curve, curves	kurva, kurvan, kurvor	N
customer, customers	kund, kunden, kunder	N
cyber security, cyber securities	cybersäkerhet, cybersäkerheten, cybersäkerheter	N
cyberbullying, cyberbullyings	nätmobbning, nätmobbningen, nätmobbningar	N
cybernetics, cybernetics	cybernetik, cybernetiken, cybernetiker	N
cyberspace, cyberspaces	cyberrymd, cyberrymden, cyberrymder	N
cycle, cycles	cykel, cykeln, cykler	N
cyclic	cyklisk, cykliskt, cykliska	A
cylinder, cylinders	cylinder, cylindern, cylindrar	N
daemon, daemons	daemon, daemonet, daemons	N
data abstraction, data abstractions	dataabstraktion, dataabstraktionen, dataabstraktioner	N
data center, data centers	datorhall, datorhallen, datorhallar	N
data collection, data collections	datasamling, datasamlingen, datasamlingar	N
data communication, data communications	datakommunikation, datakommunikationen, datakommunikationer	N
data dependency, data dependencies	databeroende, databeroendet, databeroenden	N
data management, data managements	datahantering, datahanteringen, datahanteringar	N
data mining, data minings	datautvinning, datautvinningen, datautvinningar	N
data processing, data processings	databehandling, databehandlingen, databehandlingar	N
data set, data sets	datamängd, datamängden, datamängder	N
data storage device, data storage devices	lagringsmedium, lagringsmediumet, lagringsmedium	N
data structure, data structures	datastruktur, datastrukturen, datastrukturer	N
data type, data types	datatyp, datatypen, datatyper	N
data, datas	data, datan, data	N
database administator, database administators	databasadministratör, databasadministratören, databasadministratörer	N
database, databases	databas, databasen, databaser	N
day, days	dag, dagen, dagar	N
death, deaths	död, döden, dödar	N
debugger, debuggers	avlusare, avlusaren, avlusare	N
decide, decided, decided	 bestämma, bestämde, bestämt	V
decimal, decimals	decimal, decimalen, decimaler	N
declaration, declarations	deklaration, deklarationen, deklarationer	N
declare, declared, declared	 deklarera, deklarerade, deklarerat	V
decompose, decomposed, decomposed	 nedbryta, nedbröt, nedbrutit	V
default, defaults	standard, standarden, standarder	N
define, defined, defined	 definiera, definierade, definierat	V
definition, definitions	definition, definitionen, definitioner	N
definitive	avgörande, avgörande, avgörande	A
degree, degrees	examen, examen, examina	N
delay, delays	fördröjning, fördröjningen, fördröjningar	N
delete, deleted, deleted	 radera, raderade, raderat	V
delivery, deliveries	leverans, leveransen, leveranser	N
denial, denials	avslag, avslaget, avslag	N
density, densities	densitet, densiteten, densiteter	N
dependency, dependencies	beroende, beroendet, beroenden	N
depth, depths	djup, djupet, djup	N
derive, derived, derived	 derivera, deriverade, deriverat	V
description, descriptions	beskrivning, beskrivningen, beskrivningar	N
descriptive	beskrivande, beskrivande, beskrivande	A
design pattern, design patterns	designmönster, designmönstret, designmönster	N
design process, design processes	designprocess, designprocessen, designprocesser	N
design, designed, designed	 designa, designade, designat	V
design, designs	design, designen, designer	N
desirable	önskvärd, önskvärt, önskvärda	A
desktop computer, desktop computers	skrivbordsdator, skrivbordsdatorn, skrivbordsdatorer	N
desktop, desktops	skrivbord, skrivbordet, skrivbord	N
detect, detected, detected	 upptäcka, upptäckte, upptäckt	V
detection, detections	upptäckt, upptäckten, upptäckter	N
determine, determined, determined	 fastställa, fastställde, fastställt	V
deterministic	deterministisk, deterministiskt, deterministiska	A
develop, developed, developed	 utveckla, utvecklade, utvecklat	V
developer, developers	utvecklare, utvecklaren, utvecklare	N
development environment, development environments	utvecklingsmiljö, utvecklingsmiljöen, utvecklingsmiljöer	N
development process, development processes	utvecklingsprocess, utvecklingsprocessen, utvecklingsprocesser	N
development, developments	utveckling, utvecklingen, utvecklingar	N
device driver, device drivers	drivrutin, drivrutinen, drivrutiner	N
device, devices	enhet, enheten, enheter	N
diagram, diagrams	diagram, diagrammet, diagram	N
dictionary, dictionaries	lexikon, lexikonet, lexikon	N
different	annorlunda, annorlunda, annorlunda	A
differentiable	differentierbar, differentierbart, differentierbara	A
differential equation, differential equations	differentialekvation, differentialekvationen, differentialekvationer	N
digital	digital, digitalt, digitala	A
digital signal processor, digital signal processors	signalprocessor, signalprocessorn, signalprocessorer	N
dimension, dimensions	dimension, dimensionen, dimensioner	N
dimensional	dimensionell, dimensionellt, dimensionella	A
diode, diodes	diod, dioden, dioder	N
directional	riktad, riktat, riktade	A
directory, directories	katalog, katalogen, kataloger	N
disaster, disasters	katastrof, katastrofen, katastrofer	N
disc, discs	disk, disken, diskar	N
discovery, discoveries	upptäckt, upptäckten, upptäckter	N
discreet	diskret, diskret, diskreta	A
discrete	diskret, diskret, diskreta	A
discrete mathematics, discrete mathematics	diskret matematik, diskreta matematiken, diskreta matematikar	N
discretionary	oinskränkt, oinskränkt, oinskränkta	A
discuss, discussed, discussed	 diskutera, diskuterade, diskuterat	V
disjunction, disjunctions	disjunktion, disjunktionen, disjunktioner	N
disk, disks	disk, disken, diskar	N
display, displayed, displayed	 uppvisa, uppvisade, uppvisat	V
display, displays	bildskärm, bildskärmen, bildskärmar	N
distribute, distributed, distributed	 distribuera, distribuerade, distribuerat	V
distributed systems, distributed systemses	distribuerat system, distribuerade systemet, distribuerade system	N
distribution, distributions	distribution, distributionen, distributioner	N
distributor, distributors	återförsäljare, återförsäljaren, återförsäljare	N
divide, divided, divided	 dela, delade, delat	V
division, divisions	division, divisionen, divisioner	N
document, documented, documented	 dokumentera, dokumenterade, dokumenterat	V
document, documents	dokument, dokumentet, dokument	N
documentation, documentations	dokumentation, dokumentationen, dokumentationer	N
domain name system, domain name systems	domännamnssystem, domännamnssystemet, domännamnssystem	N
domain name, domain names	domännamn, domännamnet, domännamn	N
domain, domains	domän, domänen, domäner	N
domain-specific language, domain-specific languages	domänspecifikt språk, domänspecifika språket, domänspecifika språk	N
dot, dots	punkt, punkten, punkter	N
double, doubled, doubled	 dubbla, dubblade, dubblat	V
double, doubles	dubbel, dubblet, dubbel	N
download, downloaded, downloaded	 hämta, hämtade, hämtat	V
download, downloads	nedladdning, nedladdningen, nedladdningar	N
drag, dragged, dragged	 dra, drade, drat	V
drive, drives	disk, disken, diskar	N
drop, dropped, dropped	 släppa, släppte, släppt	V
drop, drops	fall, fallet, fall	N
dynamic	dynamisk, dynamiskt, dynamiska	A
dynamic programming, dynamic programmings	dynamisk programmering, dynamiska programmeringen, dynamiska programmeringar	N
dynamic, dynamics	dynamik, dynamiken, dynamiker	N
dynamics, dynamics	dynamik, dynamiken, dynamiker	N
edition, editions	upplaga, upplagan, upplagor	N
editor, editors	redigerare, redigeraren, redigerare	N
education, educations	utbildning, utbildningen, utbildningar	N
educational program, educational programs	utbildningsprogram, utbildningsprogrammet, utbildningsprogram	N
educational programme, educational programmes	utbildningsprogram, utbildningsprogrammet, utbildningsprogram	N
effect, effected, effected	 genomföra, genomförde, genomfört	V
effect, effects	effekt, effekten, effekter	N
effective	effektiv, effektivt, effektiva	A
efficient	effektiv, effektivt, effektiva	A
electrical	elektrisk, elektriskt, elektriska	A
electricity, electricities	elektricitet, elektriciteten, elektriciteter	N
electromagnetic	elektromagnetisk, elektromagnetiskt, elektromagnetiska	A
electromagnetic wave, electromagnetic waves	elektromagnetisk strålning, elektromagnetiska strålningen, elektromagnetiska strålningar	N
electronic	elektronisk, elektroniskt, elektroniska	A
electronics, electronics	elektronik, elektroniken, elektroniker	N
element, elements	element, elementet, element	N
elliptic	elliptisk, elliptiskt, elliptiska	A
embed, embedded, embedded	 inbädda, inbäddade, inbäddat	V
emergency, emergencys	kris, krisen, kriser	N
empirical	empirisk, empiriskt, empiriska	A
employee, employees	anställd, anställda, anställda	N
empty set, empty sets	tom mängd, tomma mängden, tomma mängder	N
enable, enabled, enabled	 möjliggöra, möjliggjorde, möjliggjort	V
encapsulation, encapsulations	inkapsling, inkapslingen, inkapslingar	N
encode, encoded, encoded	 koda, kodade, kodat	V
encrypt, encrypted, encrypted	 kryptera, krypterade, krypterat	V
encryption, encryptions	kryptering, krypteringen, krypteringar	N
end user, end users	slutanvändare, slutanvändaren, slutanvändare	N
end, ended, ended	 avsluta, avslutade, avslutat	V
end, ends	slut, slutet, slut	N
energy, energies	energi, energin, energier	N
engine, engines	motor, motorn, motorer	N
engineering, engineerings	ingenjörsvetenskap, ingenjörsvetenskapen, ingenjörsvetenskaper	N
enhance, enhanced, enhanced	 höja, höjde, höjt	V
enhancement, enhancements	förbättring, förbättringen, förbättringar	N
entity, entities	entitet, entiteten, entiteter	N
entry requirement, entry requirements	behörighet, behörigheten, behörigheter	N
entry, entries	inträde, inträdet, inträden	N
environment, environments	miljö, miljön, miljöer	N
equalizer, equalizers	utjämnare, utjämnaren, utjämnare	N
equation, equations	ekvation, ekvationen, ekvationer	N
equipment, equipments	utrustning, utrustningen, utrustningar	N
error, errors	fel, felet, fel	N
escape, escaped, escaped	 fly, flydde, flytt	V
escape, escapes	flykt, flykten, flykter	N
essential	essentiell, essentiellt, essentiella	A
essential, essentials	väsentlighet, väsentligheten, väsentligheter	N
establish, established, established	 etablera, etablerade, etablerat	V
estimate, estimated, estimated	 estimera, estimerade, estimerat	V
ethernet, ethernets	ethernet, ethernetet, ethernet	N
ethical aspect, ethical aspects	etisk aspekt, etiska aspekten, etiska aspekter	N
ethics, ethics	etik, etiken, etiker	N
evaluate, evaluated, evaluated	 evaluera, evaluerade, evaluerat	V
evaluation, evaluations	evaluering, evalueringen, evalueringar	N
event, events	händelse, händelsen, händelser	N
evolution, evolutions	evolution, evolutionen, evolutioner	N
examination hall exam, examination hall exams	salstentamen, salstentamen, salstentamina	N
examination, examinations	examination, examinationen, examinationer	N
example, examples	exempel, exemplet, exempel	N
exception handling, exception handlings	undantagshantering, undantagshanteringen, undantagshanteringar	N
exception, exceptions	undantag, undantaget, undantag	N
exchange, exchanged, exchanged	 byta, bytte, bytt	V
exchange, exchanges	utbyte, utbytet, utbyten	N
executable	exekverbar, exekverbart, exekverbara	A
execute, executed, executed	 exekvera, exekverade, exekverat	V
execution, executions	exekvering, exekveringen, exekveringar	N
exemplify, exemplified, exemplified	 exemplifiera, exemplifierade, exemplifierat	V
exercise, exercises	övning, övningen, övningar	N
expand, expanded, expanded	 utöka, utökade, utökat	V
expansion bus, expansion buses	expansionskort, expansionskortet, expansionskort	N
expansion, expansions	expansion, expansionen, expansioner	N
expense, expenses	utgift, utgiften, utgifter	N
experience, experienced, experienced	 erfarenhet, erfarenhetdde, erfarenhettt	V
experiment, experimented, experimented	 experimentera, experimenterade, experimenterat	V
expert, experts	expert, experten, experter	N
explicit	tydlig, tydligt, tydliga	A
explore, explored, explored	 utforska, utforskade, utforskat	V
express, expressed, expressed	 uttrycka, uttryckte, uttryckt	V
expression, expressions	uttryck, uttrycket, uttryck	N
extend, extended, extended	 utöka, utökade, utökat	V
extension, extensions	förlängning, förlängningen, förlängningar	N
exterior	yttre, yttre, yttre	A
exterior, exteriors	yttre, yttret, yttren	N
external	extern, externt, externa	A
extract, extracted, extracted	 extrahera, extraherade, extraherat	V
extract, extracts	utdrag, utdraget, utdrag	N
extraction, extractions	extraktion, extraktionen, extraktioner	N
extreme	extrem, extremt, extrema	A
facility, facilities	möjlighet, möjligheten, möjligheter	N
factor, factors	faktor, faktorn, faktorer	N
factory, factories	fabrik, fabriken, fabriker	N
false	falsk, falskt, falska	A
fan, fanned, fanned	 fläkta, fläktade, fläktat	V
fan, fans	fläkt, fläkten, fläktar	N
fast	snabb, snabbt, snabba	A
fault, faults	fel, felet, fel	N
feasibility study, feasibility studies	förstudie, förstudien, förstudier	N
feature, features	funktion, funktionen, funktioner	N
feed, feeds	flöde, flödet, flöden	N
field, fields	fält, fältet, fält	N
file format, file formats	filformat, filformatet, filformat	N
file name, file names	filnamn, filnamnet, filnamn	N
file, filed, filed	 arkivera, arkiverade, arkiverat	V
file, files	fil, filen, filer	N
filename extension, filename extensions	filändelse, filändelsen, filändelser	N
filing, filings	arkivering, arkiveringen, arkiveringar	N
filter, filtered, filtered	 filtrera, filtrerade, filtrerat	V
finance, financed, financed	 finansiera, finansierade, finansierat	V
finite	ändlig, ändligt, ändliga	A
firewall, firewalls	brandvägg, brandväggen, brandväggar	N
firmware, firmwares	firmware, firmwaret, firmwares	N
flash memory, flash memories	flashminne, flashminnet, flashminnen	N
flash, flashed, flashed	 blinka, blinkade, blinkat	V
flash, flashes	sken, skenet, sken	N
flight simulator, flight simulators	flygsimulator, flygsimulatorn, flygsimulatorer	N
floating point number, floating point numbers	flyttal, flyttalet, flyttal	N
floppy disk, floppy disks	diskett, disketten, disketter	N
flow, flows	flöde, flödet, flöden	N
fluid	flytande, flytande, flytande	A
fluid, fluids	vätska, vätskan, vätskor	N
focus, focused, focused	 fokusera, fokuserade, fokuserat	V
forgery, forgeries	förfalskning, förfalskningen, förfalskningar	N
form factor, form factors	formfaktor, formfaktoren, formfaktorer	N
form, forms	formulär, formuläret, formulär	N
formal	formell, formellt, formella	A
formal verification, formal verifications	formell verifiering, formella verifieringen, formella verifieringar	N
format, formats	format, formatet, format	N
formula, formulas	formel, formeln, formler	N
formulate, formulated, formulated	 formulera, formulerade, formulerat	V
forwarding, forwardings	spedition, speditionen, speditioner	N
foundation, foundations	grund, grunden, grunder	N
frame, frames	ram, ramen, ramar	N
framework, frameworks	ramverk, ramverket, ramverk	N
free	fri, fritt, fria	A
free, freed, freed	 fria, friade, friat	V
frequency, frequencys	frekvens, frekvensen, frekvenser	N
front, fronts	front, fronten, fronter	N
frontier, frontiers	gräns, gränsen, gränser	N
full	full, fullt, fulla	A
function, functioned, functioned	 fungera, fungerade, fungerat	V
function, functions	funktion, funktionen, funktioner	N
functional	funktionell, funktionellt, funktionella	A
functional programming, functional programmings	funktionell programmering, funktionella programmeringen, funktionella programmeringar	N
functionality, functionalities	funktionalitet, funktionaliteten, funktionaliteter	N
fundamental	fundamental, fundamentalt, fundamentala	A
fundamental, fundamentals	fundamental, fundamentalet, fundamental	N
future	framtida, framtida, framtida	A
game engine, game engines	spelmotor, spelmotorn, spelmotorer	N
game theory, game theories	spelteori, spelteorin, spelteorier	N
game, gamed, gamed	 spela, spelade, spelat	V
game, games	spel, spelet, spel	N
garbage collection, garbage collections	skräpsamling, skräpsamlingen, skräpsamlingar	N
garbage, garbages	skräp, skräpet, skräp	N
gate, gates	grind, grinden, grindar	N
gateway, gateways	port, porten, portar	N
general	allmän, allmänt, allmänna	A
generalization, generalizations	generalisering, generaliseringen, generaliseringar	N
generalize, generalized, generalized	 generalisera, generaliserade, generaliserat	V
generate, generated, generated	 generera, genererade, genererat	V
generation, generations	generation, generationen, generationer	N
generative	generativ, generativt, generativa	A
generic	generisk, generiskt, generiska	A
genetic	generisk, generiskt, generiska	A
geographic	geografisk, geografiskt, geografiska	A
geography, geographys	geografi, geografiet, geografi	N
geometric	geometrisk, geometriskt, geometriska	A
geometry, geometries	geometri, geometrin, geometrier	N
gigabit, gigabits	gigabit, gigabiten, gigabitar	N
gigabyte, gigabytes	gigabyte, gigabyten, gigabyte	N
global	global, globalt, globala	A
global variable, global variables	global variabel, globala variabeln, globala variabler	N
globalization, globalizations	globalisering, globaliseringen, globaliseringar	N
goal, goals	mål, målet, mål	N
grammar, grammars	grammatik, grammatiken, grammatiker	N
graph theory, graph theories	grafteori, grafteorin, grafteorier	N
graph, graphs	graf, grafen, grafer	N
graphic	grafisk, grafiskt, grafiska	A
graphic, graphics	grafik, grafiken, grafiker	N
graphical	grafisk, grafiskt, grafiska	A
graphical user interface, graphical user interfaces	grafiskt användargränssnitt, grafiska användargränssnittet, grafiska användargränssnitt	N
graphics card, graphics cards	grafikkort, grafikkortet, grafikkort	N
graphics processing unit, graphics processing units	grafikprocessor, grafikprocessorn, grafikprocessorer	N
grid, grids	rutnät, rutnätet, rutnät	N
group, groups	grupp, gruppen, grupper	N
guard, guards	vakt, vakten, vakter	N
guideline, guidelines	riktlinje, riktlinjen, riktlinjer	N
handler, handlers	hanterare, hanteraren, hanterare	N
handshake, handshakes	handskakning, handskakningen, handskakningar	N
hard	hård, hårt, hårda	A
hard	svår, svårt, svåra	A
hard disk drive, hard disk drives	hårddisk, hårddisken, hårddiskar	N
hard drive, hard drives	hårddisk, hårddisken, hårddiskar	N
hardware acceleration, hardware accelerations	hårdvaruacceleration, hårdvaruaccelerationen, hårdvaruaccelerationer	N
hardware system, hardware systems	hårdvarusystem, hårdvarusystemet, hårdvarusystem	N
hardware unit, hardware units	hårdvaruenhet, hårdvaruenheten, hårdvaruenheter	N
hardware, hardwares	hårdvara, hårdvaran, hårdvaror	N
hash function, hash functions	hashfunktion, hashfunktionen, hashfunktioner	N
hash table, hash tables	hashtabell, hashtabellen, hashtabeller	N
head, headed, headed	 leda, ledde, lett	V
head, heads	huvud, huvudet, huvuden	N
heapsort, heapsorts	heapsortering, heapsorteringen, heapsorteringar	N
hertz, hertzes	hertz, hertzen, hertz	N
heuristic, heuristics	heuristik, heuristiken, heuristiker	N
hide, hid, hidden	 dölja, dolde, dolt	V
hierarchical	hierarkisk, hierarkiskt, hierarkiska	A
hierarchy, hierarchies	hierarki, hierarkin, hierarkier	N
high	hög, högt, höga	A
hint, hinted, hinted	 antyda, antydde, antytt	V
hint, hints	antydan, antydan, antydningar	N
histogram, histograms	histogram, histogrammet, histogram	N
hit, hits	träff, träffen, träffar	N
holding, holdings	innehav, innehavet, innehav	N
holistic approach, holistic approaches	helhetssyn, helhetssynen, helhetssyner	N
host, hosts	värd, värden, värdar	N
hotkey, hotkeys	snabbvalstangent, snabbvalstangenten, snabbvalstangenter	N
hub, hubs	centrum, centrumet, centra	N
human, humans	människa, människan, människor	N
human-computer interation, human-computer interations	människa-datorinteraktion, människa-datorinteraktionen, människa-datorinteraktioner	N
hybrid, hybrids	hybrid, hybriden, hybrider	N
hyperlink, hyperlinks	hyperlänk, hyperlänken, hyperlänkar	N
hypertext, hypertexts	hypertext, hypertexten, hypertexter	N
identifier, identifiers	identifierare, identifieraren, identifierare	N
identify, identified, identified	 identifiera, identifierade, identifierat	V
identity, identities	identitet, identiteten, identiteter	N
if-loop, if-loops	if-loop, if-loopen, if-loopar	N
if-statement, if-statements	if-sats, if-satsen, if-satser	N
image, imaged, imaged	 föreställa, föreställde, föreställt	V
image, images	bild, bilden, bilder	N
imagery, imageries	bildsamling, bildsamlingen, bildsamlingar	N
immutable	oföränderlig, oföränderligt, oföränderliga	A
impact, impacts	verkan, verkan, verkan	N
imperative	imperativ, imperativt, imperativa	A
imperative programming, imperative programmings	imperativ programmering, imperativa programmeringen, imperativa programmeringar	N
implement, implemented, implemented	 implementera, implementerade, implementerat	V
implementation problem, implementation problems	implementationsproblem, implementationsproblemet, implementationsproblem	N
implementation, implementations	implementering, implementeringen, implementeringar	N
implication, implications	implikation, implikationen, implikationer	N
improve, improved, improved	 förbättra, förbättrade, förbättrat	V
improvement, improvements	förbättring, förbättringen, förbättringar	N
include, included, included	 inkludera, inkluderade, inkluderat	V
incremental	inkrementell, inkrementellt, inkrementella	A
independent	oberoende, oberoende, oberoende	A
index, indexes	index, indexet, index	N
indicator, indicators	indikator, indikatorn, indikatorer	N
indirect	indirekt, indirekt, indirekta	A
individual	individuell, individuellt, individuella	A
individual, individuals	individ, individen, individer	N
induction, inductions	induktion, induktionen, induktioner	N
industrial	industriell, industriellt, industriella	A
industry, industries	industri, industrin, industrier	N
inference, inferences	inferens, inferensen, inferenser	N
information system, information systems	informationssystem, informationssystemet, informationssystem	N
information technology, information technologies	informationsteknik, informationstekniken, informationsteknikar	N
information theory, information theories	informationsteori, informationsteorien, informationsteoriar	N
information, informations	information, informationen, informationer	N
infrastructure, infrastructures	infrastruktur, infrastrukturen, infrastrukturer	N
inheritance, inheritances	arv, arvet, arv	N
initialization, initializations	initiering, initieringen, initieringar	N
initialize, initialized, initialized	 initialisera, initialiserade, initialiserat	V
initiative, initiatives	initiativ, initiativet, initiativ	N
injection, injections	injektion, injektionen, injektioner	N
input, inputs	indata, indatan, indata	N
insertion sort, insertion sorts	insättningssortering, insättningssorteringen, insättningssorteringar	N
insertion, insertions	införande, införandet, införanden	N
inspection, inspections	granskning, granskningen, granskningar	N
instance, instances	instans, instansen, instanser	N
institute, instituted, instituted	 införa, införde, infört	V
institute, institutes	institut, institutet, institut	N
instruction set architecture, instruction set architectures	instruktionsuppsättning, instruktionsuppsättningen, instruktionsuppsättningar	N
instruction, instructions	instruktion, instruktionen, instruktioner	N
instrument, instruments	instrument, instrumentet, instrument	N
instrumentation, instrumentations	instrumentering, instrumenteringen, instrumenteringar	N
integer, integers	heltal, heltalet, heltal	N
integrate, integrated, integrated	 integrera, integrerade, integrerat	V
integrated circuit, integrated circuits	integrerad krets, integrerade kretsen, integrerade kretsar	N
integrated development environment, integrated development environments	integrerad utvecklingsmiljö, integrerade utvecklingsmiljöen, integrerade utvecklingsmiljöer	N
integration, integrations	integration, integrationen, integrationer	N
integrity, integrities	integritet, integriteten, integriteter	N
intellectual	intellektuell, intellektuellt, intellektuella	A
intelligence, intelligences	intelligens, intelligensen, intelligenser	N
intelligent	intelligent, intelligent, intelligenta	A
inter-process communication, inter-process communications	interprocesskommunikation, interprocesskommunikationen, interprocesskommunikationer	N
interaction, interactions	interaktion, interaktionen, interaktioner	N
interactive	interaktiv, interaktivt, interaktiva	A
interchange, interchanged, interchanged	 växla, växlade, växlat	V
interchange, interchanges	utbyte, utbytet, utbyten	N
interconnect, interconnected, interconnected	 sammanlänka, sammanlänkade, sammanlänkat	V
interconnection, interconnections	sammanlänkning, sammanlänkningen, sammanlänkningar	N
interdisciplinary	tvärvetenskaplig, tvärvetenskapligt, tvärvetenskapliga	A
interested	interesserad, interesserat, interesserade	A
interface design, interface designs	gränssnittsdesign, gränssnittsdesignen, gränssnittsdesigner	N
interface, interfaces	gränssnitt, gränssnittet, gränssnitt	N
interference, interferences	interferens, interferensen, interferenser	N
interior	inre, inre, inre	A
interior, interiors	inrede, inredet, inreden	N
interleave, interleaved, interleaved	 interfoliera, interfolierade, interfolierat	V
intermediate	mellanliggande, mellanliggande, mellanliggande	A
internal	intern, internt, interna	A
international	internationell, internationellt, internationella	A
internationalization, internationalizations	internationalisering, internationaliseringen, internationaliseringar	N
internationalize, internationalized, internationalized	 internationalisera, internationaliserade, internationaliserat	V
internet, internets	internet, internet, internet	N
interpret, interpreted, interpreted	 interpretera, interpreterade, interpreterat	V
interpretation, interpretations	tolkning, tolkningen, tolkningar	N
interrupt, interrupted, interrupted	 avbryta, avbröt, avbrutit	V
interruption, interruptions	avbrott, avbrottet, avbrott	N
interval, intervals	intervall, intervallet, intervaller	N
introduce, introduced, introduced	 introducera, introducerade, introducerat	V
introduction, introductions	introduktion, introduktionen, introduktioner	N
intrusion, intrusions	intrång, intrånget, intrång	N
invariant	invariant, invariant, invarianta	A
invocation, invocations	invokation, invokationen, invokationer	N
ip-adress, ip-adresses	ip-address, ip-addressen, ip-addresser	N
irregular	oregelbunden, oregelbundet, oregelbundna	A
issue, issues	problem, problemet, problem	N
iteration, iterations	iteration, iterationen, iterationer	N
iterative	iterativ, iterativt, iterativa	A
job, jobs	arbete, arbetet, arbeten	N
junction, junctions	förbindelse, förbindelsen, förbindelser	N
kernel, kernels	kärna, kärnan, kärnor	N
key feature, key features	huvudfunktion, huvudfunktionen, huvudfunktioner	N
keyboard, keyboards	tangentbord, tangentbordet, tangentbord	N
kibibyte, kibibytes	kibibyte, kibibyten, kibibytar	N
kilobit, kilobits	kilobit, kilobiten, kilobitar	N
kilobyte, kilobytes	kilobyte, kilobyten, kilobyte	N
kilohertz, kilohertzes	kilohertz, kilohertzen, kilohertz	N
kind, kinds	sort, sorten, sorter	N
kit, kits	verktyg, verktyget, verktyg	N
knowledge, knowledges	kunskap, kunskapen, kunskaper	N
lab, labs	labb, labben, labbar	N
label, labeled, labeled	 beteckna, betecknade, betecknat	V
label, labels	etikett, etiketten, etiketter	N
laboratory task, laboratory tasks	laboration, laborationen, laborationer	N
language extension, language extensions	språkutvidgning, språkutvidgningen, språkutvidgningar	N
language, languages	språk, språket, språk	N
laptop, laptops	laptop, laptoppen, laptoppar	N
large	stor, stort, stora	A
laser, lasers	laser, lasern, lasrar	N
law, laws	lag, lagen, lagar	N
layer, layers	lager, lagret, lager	N
layout, layouts	layout, layouten, layouter	N
lazy	lat, lat, lata	A
learn, learnt, learnt	 lära, lärde, lärt	V
learning outcome, learning outcomes	lärandemål, lärandemålet, lärandemål	N
learning, learnings	bildning, bildningen, bildningar	N
lecture, lectures	föreläsning, föreläsningen, föreläsningar	N
letters, letterses	bokstäver, bokstävret, bokstäver	N
level, levels	nivå, nivån, nivåer	N
library, libraries	bibliotek, biblioteket, bibliotek	N
library, libraries	programbibliotek, programbiblioteket, programbibliotek	N
licence, licences	licens, licensen, licenser	N
license, licensed, licensed	 licensiera, licensierade, licensierat	V
light, lights	ljus, ljuset, ljus	N
lightweight	lätt, lätt, lätta	A
limit, limited, limited	 begränsa, begränsade, begränsat	V
limit, limits	gräns, gränsen, gränser	N
line, lines	linje, linjen, linjer	N
linear	linjär, linjärt, linjära	A
linear search, linear searches	linjärsökning, linjärsökningen, linjärsökningar	N
linguistics, linguistics	språkvetenskap, språkvetenskapen, språkvetenskaper	N
link, linked, linked	 knyta, knöt, knutit	V
link, links	länk, länken, länkar	N
linked list, linked lists	länkad lista, länkade listan, länkade listor	N
linux, linuxes	linux, linuxet, linux	N
liquid	flytande, flytande, flytande	A
liquid, liquids	vätska, vätskan, vätskor	N
list, listed, listed	 lista, listade, listat	V
list, lists	lista, listan, listor	N
literature, literatures	litteratur, litteraturen, litteraturer	N
litterature study, litterature studies	litteraturstudie, litteraturstudien, litteraturstudier	N
load, loaded, loaded	 ladda, laddade, laddat	V
load, loads	laddning, laddningen, laddningar	N
loader, loaders	lastare, lastaren, lastare	N
loading, loadings	laddning, laddningen, laddningar	N
local	lokal, lokalt, lokala	A
locality, localities	lokalitet, lokaliteten, lokaliteter	N
localization, localizations	lokalisering, lokaliseringen, lokaliseringar	N
logarithm, logarithms	logaritm, logaritmen, logaritmer	N
logic programming, logic programmings	logikprogrammering, logikprogrammeringen, logikprogrammeringar	N
logic, logics	logik, logiken, logiker	N
logical	logisk, logiskt, logiska	A
logo, logos	logga, loggan, loggor	N
look, looked, looked	 titta, tittade, tittat	V
loop, loops	loop, loopen, loopar	N
loss, losses	förlust, förlusten, förluster	N
lossless	förlustlös, förlustlöst, förlustlösa	A
machine code, machine codes	maskinkod, maskinkoden, maskinkoder	N
machine learning, machine learnings	maskininlärning, maskininlärningen, maskininlärningar	N
machine, machines	maskin, maskinen, maskiner	N
machinery, machineries	maskineri, maskineriet, maskinerier	N
magnetic	magnetisk, magnetiskt, magnetiska	A
mail, mailed, mailed	 posta, postade, postat	V
mail, mails	mail, mailet, mail	N
main	huvudsaklig, huvudsakligt, huvudsakliga	A
mainframe computer, mainframe computers	stordator, stordatorn, stordatorer	N
maintain, maintained, maintained	 underhålla, underhöll, underhållit	V
maintenance, maintenances	underhåll, underhållet, underhåll	N
manageable	hanterlig, hanterligt, hanterliga	A
management, managements	förvaltning, förvaltningen, förvaltningar	N
manager, managers	manager, managern, managers	N
mandatory	obligatorisk, obligatoriskt, obligatoriska	A
mandatory access control, mandatory access controls	obligatorisk åtkomstkontroll, obligatoriska åtkomstkontrollen, obligatoriska åtkomstkontroller	N
manipulation, manipulations	manipulation, manipulationen, manipulationer	N
manufacture, manufactured, manufactured	 tillverka, tillverkade, tillverkat	V
manufacturer, manufacturers	tillverkare, tillverkaren, tillverkare	N
map, mapped, mapped	 kartlägga, kartla, kartlagt	V
map, maps	karta, kartan, kartor	N
mark, marked, marked	 markera, markerade, markerat	V
mark, marks	märke, märket, märken	N
markup, markups	påslag, påslaget, påslag	N
master, mastered, mastered	 bemästra, bemästrade, bemästrat	V
master, masters	master, mastern, mastrar	N
mathematical	matematisk, matematiskt, matematiska	A
mathematical model, mathematical models	matematisk modell, matematiska modellen, matematiska modeller	N
mathematical modelling, mathematical modellings	matematiskmodellering, matematiskmodelleringen, matematiskmodelleringar	N
mathematics, mathematics	matematik, matematiken, matematiker	N
matrix, matricies	matris, matrisen, matriser	N
maturity, maturities	mognad, mognaden, mognader	N
maximum	maximal, maximalt, maximala	A
maximum, maximums	maximum, maximumet, maximum	N
measure, measured, measured	 mäta, mätte, mätt	V
measurement, measurements	mått, måttet, mått	N
mechanical	mekanisk, mekaniskt, mekaniska	A
mechanism, mechanisms	mekanism, mekanismen, mekanismer	N
media player, media players	mediespelare, mediespelaren, mediespelare	N
media, medias	media, median, medior	N
medical	medicinsk, medicinskt, medicinska	A
medium, mediums	medium, mediet, medier	N
megabit, megabits	megabit, megabiten, megabitar	N
megabyte, megabytes	megabyte, megabyten, megabyte	N
megahertz, megahertzes	megahertz, megahertzen, megahertz	N
memory address, memory addresses	minnesadress, minnesadressen, minnesadresser	N
memory card, memory cards	minneskort, minneskortet, minneskort	N
memory hierarchy level, memory hierarchy levels	minneshierarkinivå, minneshierarkinivån, minneshierarkinivåer	N
memory hierarchy, memory hierarchies	minneshierarki, minneshierarkin, minneshierarkier	N
memory, memories	minne, minnet, minnen	N
menu bar, menu bars	menyfält, menyfältet, menyfält	N
menu, menus	meny, menyn, menyer	N
merger, mergers	sammanslagning, sammanslagningen, sammanslagningar	N
message, messages	meddelande, meddelandet, meddelanden	N
metal, metals	metall, metallen, metaller	N
method, methods	metod, metoden, metoder	N
methodology, methodologies	metodologi, metodologin, metodologier	N
microarchitecture level, microarchitecture levels	mikroarkitekturnivå, mikroarkitekturnivån, mikroarkitekturnivåer	N
microcode, microcodes	mikroprogram, mikroprogrammet, mikroprogram	N
microcontroller, microcontrollers	mikrokontroller, mikrokontrollen, mikrokontroller	N
microprocessor, microprocessors	mikroprocessor, mikroprocessorn, mikroprocessorer	N
millennium, millenniums	årtusende, årtusendet, årtusenden	N
million, millions	miljon, miljonen, miljoner	N
minimum, minimums	minimum, minimumet, minimum	N
miss, misses	miss, missen, missar	N
mode, modes	läge, läget, lägen	N
model, modeled, modeled	 modellera, modellerade, modellerat	V
model, models	modell, modellen, modeller	N
modeling, modelings	modellering, modelleringen, modelleringar	N
modelling language, modelling languages	modelleringsspråk, modelleringsspråket, modelleringsspråk	N
modelling, modellings	modellering, modelleringen, modelleringar	N
modem, modems	modem, modemet, modem	N
modern	modern, modernt, moderna	A
modifier, modifiers	modifierare, modifieraren, modifierare	N
modify, modified, modified	 modifiera, modifierade, modifierat	V
modular	modulär, modulärt, modulära	A
module, modules	modul, modulen, moduler	N
molecular	molekylär, molekylärt, molekylära	A
monad, monads	monad, monaden, monader	N
monitor, monitored, monitored	 övervaka, övervakade, övervakat	V
monitor, monitors	bildskärm, bildskärmen, bildskärmar	N
monochrome	enfärgad, enfärgat, enfärgade	A
monochrome, monochromes	monokrom, monokromen, monokromer	N
monotonic	monoton, monotont, monotona	A
mortality, mortalities	dödlighet, dödligheten, dödligheter	N
motherboard, motherboards	moderkort, moderkortet, moderkort	N
motion sensor, motion sensors	rörelsesensor, rörelsesensorn, rörelsesensorer	N
motion, motions	rörelse, rörelsen, rörelser	N
mouse, mice	mus, musen, möss	N
multi-core processor, multi-core processors	flerkärnig processor, flerkärniga processorn, flerkärniga processorer	N
multilingual	flerspråkig, flerspråkigt, flerspråkiga	A
multimedia, multimedias	multimedia, multimedian, multimedior	N
multiple	multipel, multipelt, multipla	A
multiple, multiples	mångfald, mångfalden, mångfalder	N
multiplication, multiplications	multiplikation, multiplikationen, multiplikationer	N
multiprocessing, multiprocessings	multiprocessering, multiprocesseringen, multiprocesseringar	N
multiprocessor, multiprocessors	multiprocessor, multiprocessorn, multiproccesorer	N
mutable	muterbar, muterbart, muterbara	A
name, named, named	 namnge, namngav, namngett	V
national	nationell, nationellt, nationella	A
native	inhemsk, inhemskt, inhemska	A
native, natives	infödd, infödda, infödda	N
negation, negations	negation, negationen, negationer	N
negative	negativ, negativt, negativa	A
nested	nästlad, nästlat, nästlade	A
network interface controller, network interface controllers	nätverkskort, nätverkskortet, nätverkskort	N
network protocol, network protocols	nätverksprotokoll, nätverksprotokollet, nätverksprotokoll	N
network security, network securities	nätverksäkerhet, nätverksäkerheten, nätverksäkerheter	N
network, networks	nätverk, nätverket, nätverk	N
neural	neural, neuralt, neurala	A
neural network, neural networks	neuralt nätverk, neurala nätverket, neurala nätverk	N
news, newses	nyhet, nyheten, nyheter	N
node, nodes	nod, noden, noder	N
nondeterministic	icke-deterministisk, icke-deterministiskt, icke-deterministiska	A
normal	normal, normalt, normala	A
normal form, normal forms	normalform, normalformen, normalformer	N
notation, notations	notation, notationen, notationer	N
notification, notifications	meddelande, meddelandet, meddelanden	N
number theory, number theories	talteori, talteorien, talteoriar	N
number, numbered, numbered	 omfatta, omfattade, omfattat	V
number, numbers	tal, talet, tal	N
numerical	numerisk, numeriskt, numeriska	A
numerical analysis, numerical analyses	numerisk analys, numeriska analysen, numeriska analyser	N
object orientation, object orientations	objektorientering, objektorienteringen, objektorienteringar	N
object, objected, objected	 invända, invände, invänt	V
object, objects	objekt, objektet, objekt	N
object-oriented program, object-oriented programs	objektorienterat program, objektorienterade programmet, objektorienterade program	N
objective, objectives	objektiv, objektivet, objektiv	N
obtain, obtained, obtained	 erhålla, erhöll, erhållit	V
officer, officers	officer, officern, officerer	N
open	öppen, öppet, öppna	A
operate, operated, operated	 operera, opererade, opererat	V
operating system, operating systems	operativsystem, operativsystemet, operativsystem	N
operation, operations	verksamhet, verksamheten, verksamheter	N
operator, operators	operator, operatorn, operatorer	N
optical	optisk, optiskt, optiska	A
optical disc, optical discs	optisk skiva, optiska skivan, optiska skivor	N
optical fiber, optical fibers	fiberoptik, fiberoptiken, fiberoptikar	N
optimal	optimal, optimalt, optimala	A
optimization, optimizations	optimering, optimeringen, optimeringar	N
optimize, optimized, optimized	 optimera, optimerade, optimerat	V
order, ordered, ordered	 beställa, beställde, beställt	V
order, ordered, ordered	 ordna, ordnade, ordnat	V
order, orders	ordning, ordningen, ordningar	N
organic	organisk, organiskt, organiska	A
organization, organizations	organisation, organisationen, organisationer	N
orient, oriented, oriented	 orientera, orienterade, orienterat	V
original	ursprunglig, ursprungligt, ursprungliga	A
original, originals	original, originalet, original	N
orthogonal	ortogonal, ortogonalt, ortogonala	A
os, oses	operativsystem, operativsystemet, operativsystem	N
outcome, outcomes	utfall, utfallet, utfall	N
output, outputs	utdata, urdatan, utdata	N
overcome, overcame, overcome	 överkomma, överkom, överkommit	V
overview, overviews	översikt, översikten, översikter	N
package, packages	paket, paketet, paket	N
packet, packets	paket, paketet, paket	N
page, pages	sida, sidan, sidor	N
pair programming, pair programmings	parprogrammering, parprogrammeringen, parprogrammeringar	N
pair, pairs	par, paret, par	N
panel, panels	panel, panelen, paneler	N
paradigm, paradigms	paradigm, paradigmen, paradigmer	N
parallel	parallell, parallellt, parallella	A
parallel computing, parallel computings	parallelldator, parallelldatorn, parallelldatorer	N
parallel, parallels	parallell, parallellen, paralleller	N
parallelism, parallelisms	parallelism, parallelismen, parallelismer	N
parallellization, parallellizations	parallellisering, parallelliseringen, parallelliseringar	N
parameter, parameters	parameter, parametern, parametrar	N
parse, parsed, parsed	 parsa, parsade, parsat	V
parser, parsers	parser, parsern, parsers	N
parsing, parsings	parsning, parsningen, parsningar	N
part, parts	del, delen, delar	N
partition, partitioned, partitioned	 dela, delade, delat	V
partition, partitions	partition, partitionen, partitioner	N
partnership, partnerships	partnerskap, partnerskapen, partnerskaper	N
password, passwords	lösenord, lösenordet, lösenord	N
path, paths	väg, vägen, vägar	N
pattern, patterns	mönster, mönstret, mönster	N
penalty, penalties	bestraffning, bestraffningen, bestraffningar	N
perform, performed, performed	 utföra, utförde, utfört	V
performance analysis, performance analyses	prestandaanalys, prestandaanalysen, prestandaanalyser	N
performance bottleneck, performance bottlenecks	prestandaflaskhals, prestandaflaskhalsen, prestandaflaskhalsar	N
performance optimization, performance optimizations	prestandaoptimering, prestandaoptimeringen, prestandaoptimeringar	N
performance, performances	prestanda, prestandan, prestanda	N
peripheral	yttre, yttre, yttre	A
peripheral, peripherals	kringutrustning, kringutrustningen, kringutrustningar	N
permutation, permutations	permutation, permutationen, permutationer	N
persistent	ständig, ständigt, ständiga	A
personal computer, personal computers	persondator, persondatorn, persondatorer	N
philosophy, philosophies	filosofi, filosofin, filosofier	N
physics, physics	fysik, fysiken, fysiker	N
picture, pictures	bild, bilden, bilder	N
pin, pins	stift, stiftet, stift	N
pitch, pitches	topp, toppen, toppar	N
pixel, pixels	pixel, pixeln, pixlar	N
plane, planed, planed	 plana, planade, planat	V
plane, planes	nivå, nivån, nivåer	N
planning, plannings	planering, planeringen, planeringar	N
platform, platforms	plattform, plattformen, plattformar	N
player, players	spelare, spelaren, spelare	N
point, points	punkt, punkten, punkter	N
pointer, pointers	pekare, pekaren, pekare	N
polymorph	polymorf, polymorft, polymorfa	A
polymorphism, polymorphisms	polymorfi, polymorfin, polymorfier	N
port, ports	port, porten, portar	N
portable	bärbar, bärbart, bärbara	A
portable	portabel, portabelt, portabla	A
power consumption, power consumptions	strömförbrukning, strömförbrukningen, strömförbrukningar	N
power supply, power supplies	nätaggregat, nätaggregatet, nätaggregat	N
power, powered, powered	 driva, drev, drivit	V
power, powers	kraft, kraften, krafter	N
practical	praktisk, praktiskt, praktiska	A
practice, practices	praktiken, praktiken, praktiker	N
precision, precisions	precision, precisionen, precisioner	N
precondition, preconditions	förhandsvillkor, förhandsvillkoret, förhandsvillkor	N
predicate logic, predicate logics	predikatlogik, predikatlogiken, predikatlogikar	N
predict, predicted, predicted	 förutsäga, förutsade, förutsagt	V
prediction, predictions	förutsägelse, förutsägelsen, förutsägelser	N
prepare, prepared, prepared	 förbereda, förberedde, förberett	V
prerequisite, prerequisites	förkunskapskrav, förkunskapskravet, förkunskapskrav	N
presence, presences	närvaro, närvaron, närvaro	N
presentation, presentations	presentation, presentationen, presentationer	N
prevention, preventions	förebyggande, förebyggandet, förebygganden	N
primary	primär, primärt, primära	A
primitive	primitiv, primitivt, primitiva	A
principle, principles	princip, principen, principer	N
printed circuit board, printed circuit boards	mönsterkort, mönsterkortet, mönsterkort	N
printer, printers	skrivare, skrivaren, skrivare	N
priority queue, priority queues	prioritetskö, prioritetskön, prioritetsköer	N
priority, priorities	prioritet, prioriteten, prioriteter	N
privacy, privacies	privatliv, privatlivet, privatliv	N
probability distribution, probability distributions	sannolikhetsfördelning, sannolikhetsfördelningen, sannolikhetsfördelningar	N
probability, probabilities	sannolikhet, sannolikheten, sannolikheter	N
problem solving, problem solvings	problemlösning, problemlösningen, problemlösningar	N
problem, problems	problem, problemet, problem	N
procedure, procedures	procedur, proceduren, procedurer	N
process, processes	process, processen, processer	N
processing, processings	bearbetning, bearbetningen, bearbetningar	N
processor architecture, processor architectures	processorarkitektur, processorarkitekturen, processorarkitekturer	N
processor base, processor bases	processorbas, processorbasen, processorbaser	N
processor core, processor cores	processorkärna, processorkärnan, processorkärnor	N
processor, processors	processor, processorn, processorer	N
product, products	produkt, produkten, produkter	N
productivity, productivities	produktivitet, produktiviteten, produktiviteter	N
professional	professionell, professionellt, professionella	A
proficiency, proficiencies	skicklighet, skickligheten, skickligheter	N
program code, program codes	programkod, programkoden, programkoder	N
program component, program components	programkomponent, programkomponenten, programkomponenter	N
program plan, program plans	programplan, programplanen, programplaner	N
program registration, program registrations	programregistrering, programregistreringen, programregistreringar	N
program verification, program verifications	programverifiering, programverifieringen, programverifieringar	N
program, programmed, programmed	 programmera, programmerade, programmerat	V
program, programs	program, programmet, program	N
programmable	programerbar, programerbart, programerbara	A
programmer, programmers	programmerare, programmeraren, programmerare	N
programming assignment, programming assignments	programmeringsuppgift, programmeringsuppgiften, programmeringsuppgifter	N
programming course, programming courses	programmeringskurs, programmeringskursen, programmerinskurser	N
programming language, programming languages	programmeringsspråk, programmeringsspråket, programmeringsspråk	N
programming paradigm, programming paradigms	programmeringsparadigm, programmeringsparadigmet, programmeringsparadigm	N
programming problem, programming problems	programmeringsproblem, programmeringsproblemet, programmeringsproblem	N
programming skill, programming skills	programmeringskunskap, programmeringskunskapen, programmeringskunskaper	N
programming, programmings	programmering, programmeringen, programmeringar	N
progress, processes	framgång, framgången, framgångar	N
project, projected, projected	 framhäva, framhävde, framhävt	V
project, projects	projekt, projektet, projekt	N
proof, proofs	bevis, beviset, bevis	N
property, properties	egenskap, egenskapen, egenskaper	N
propositional logic, propositional logics	satslogik, satslogiken, satslogiker	N
protection, protections	skydd, skyddet, skydd	N
protocol, protocols	protokoll, protokollet, protokoll	N
prototype, prototypes	prototyp, prototypen, prototyper	N
provider, providers	leverantör, leverantören, leverantörer	N
public	publik, publikt, publika	A
public, publics	allmänhet, allmänheten, allmänheter	N
publish, published, published	 publicera, publicerade, publicerat	V
purpose, purposes	syfte, syftet, syften	N
quality, qualities	kvalitet, kvaliteten, kvaliteter	N
quantitative	kvantitiv, kvantitivt, kvantitiva	A
quantum computer, quantum computers	kvantdator, kvantdatorn, kvantdatorer	N
query, queries	fråga, frågan, frågor	N
question, questioned, questioned	 ifrågasätter, ifrågasatte, ifrågasatt	V
queue, queued, queued	 köa, köade, köat	V
queue, queues	kö, kön, köer	N
quick	snabb, snabbt, snabba	A
radio, radios	radio, radion, radior	N
random	slumpmässig, slumpmässigt, slumpmässiga	A
randomization, randomizations	randomisering, randomiseringen, randomiseringar	N
rapid	snabb, snabbt, snabba	A
rate, rated, rated	 räkna, räknade, räknat	V
rate, rates	takt, takten, takter	N
ratio, ratios	kvot, kvoten, kvoter	N
raw	rå, rått, råa	A
ray, rayed, rayed	 stråla, strålade, strålat	V
ray, rays	stråle, strålen, strålar	N
read, read, read	 läsa, läste, läst	V
reader, readers	läsare, läsaren, läsare	N
readiness, readinesses	beredskap, beredskapen, beredskaper	N
reality, realities	verklighet, verkligheten, verkligheter	N
reasoning, reasonings	resonemang, resonemanget, resonemang	N
recent	färsk, färskt, färska	A
recognition, recognitions	igenkänning, igenkänningen, igenkänningar	N
recorder, recorders	registrator, registratorn, registratorer	N
recording, recordings	inspelning, inspelningen, inspelningar	N
recoverable	återhämtningsbar, återhämtningsbart, återhämtningsbara	A
recovery, recoveries	återhämtning, återhämtningen, håterhämtningar	N
recursion, recursions	rekursion, rekursionen, rekursioner	N
recursive	rekursiv, rekursivt, rekursiva	A
recursive data type, recursive data types	rekursiv datatyp, rekursiva datatypen, rekursiva datatyper	N
reduce, reduced, reduced	 minska, minskade, minskat	V
reduction, reductions	reduktion, reduktionen, reduktioner	N
redundancy, redundancies	överskott, överskottet, överskott	N
redundant	överflödig, överflödigt, överflödiga	A
reference, references	referens, referensen, referenser	N
reflection, reflections	reflektion, reflektionen, reflektioner	N
region, regions	område, området, områden	N
register, registered, registered	 registrera, registrerade, registrerat	V
register, registers	register, registret, register	N
regular	regelbunden, regelbundet, regelbundna	A
regular expression, regular expressions	reguljärt uttryck, reguljära uttrycket, reguljära uttryck	N
reinforce, reinforced, reinforced	 förstärka, förstärkte, förstärkt	V
relate, related, related	 relatera, relaterade, relaterat	V
relation, relations	relation, relationen, relationer	N
relational database, relational databases	relationsdatabas, relationsdatabasen, relationsdatabaser	N
relationship, relationships	samband, sambandet, samband	N
relay, relays	relä, reläen, reläer	N
reliable	pålitlig, pålitligt, pålitliga	A
remote	avlägsen, avlägset, avlägsna	A
rendering, renderings	rendering, renderingen, renderingar	N
replaceable	ersättlig, ersättligt, ersättliga	A
replacement, replacements	ersättning, ersättningen, ersättningar	N
report, reported, reported	 rapportera, rapporterade, rapporterat	V
report, reports	rapport, rapporten, rapporter	N
request, requested, requested	 begära, begärde, begärt	V
request, requests	begäran, begäran, begäran	N
require, required, required	 kräva, krävde, krävt	V
requirement, requirements	krav, kravet, krav	N
requirements analysis, requirements analyses	kravhantering, kravhanteringen, kravhanteringar	N
research, researched, researched	 efterforska, efterforskade, efterforskat	V
research, researches	forskning, forskningen, forskningar	N
reservation, reservations	bokning, bokningen, bokningar	N
resolution, resolutions	upplösning, upplösningen, upplösningar	N
resource requirement search, resource requirement searches	resurskravsökning, resurskravsökningen, resurskravsökningar	N
resource, resources	resurs, resursen, resurser	N
response, responses	respons, responsen, responser	N
responsibility, responsibilities	ansvar, ansvaret, ansvar	N
result, results	resultat, resultatet, resultat	N
robot, robots	robot, roboten, robotar	N
robotics, robotics	robotik, robotiken, robotiker	N
role, roles	roll, rollen, roller	N
root, rooted, rooted	 roota, rootade, rootat	V
router, routers	router, routern, routrar	N
routine, routines	rutin, rutinen, rutiner	N
routing protocol, routing protocols	routingprotokoll, routingprotokollet, routingprotokoll	N
routing table, routing tables	dirigeringstabell, dirigeringstabellen, dirigeringstabeller	N
rule, rules	regel, regeln, regler	N
run, ran, run	 köra, körde, kört	V
runtime error, runtime errors	exekveringsfel, exekveringsfelet, exekveringsfel	N
runtime, runtimes	körningstid, körningstiden, körningstider	N
safety, safeties	säkerhet, säkerheten, säkerheter	N
sample, sampled, sampled	 provsmaka, provsmakade, provsmakat	V
satisfaction, satisfactions	tillfredsställelse, tillfredsställelsen, tillfredsställelser	N
save, saved, saved	 spara, sparade, sparat	V
scalability, scalabilities	skalbarhet, skalbarheten, skalbarheter	N
scale, scaled, scaled	 skala, skalade, skalat	V
scale, scales	skala, skalan, skalor	N
scanner, scanners	skanner, skannern, skannrar	N
science, sciences	vetenskap, vetenskapen, vetenskaper	N
scientific	vetenskaplig, vetenskapligt, vetenskapliga	A
scope, scopes	räckvidd, räckvidden, räckvidder	N
scramble, scrambled, scrambled	 förvränga, förvrängde, förvrängt	V
scratch, scratched, scratched	 repa, repade, repat	V
scratch, scratches	repa, repan, repor	N
screen, screens	skärm, skärmen, skärmar	N
screensaver, screensavers	skärmsläckare, skärmsläckaren, skärmsläckare	N
scripting language, scripting languages	skriptspråk, skriptspråken, skriptspråkar	N
search, searched, searched	 söka, sökte, sökt	V
section, sections	sektion, sektionen, sektioner	N
sector, sectors	sektor, sektorn, sektorer	N
secure, secured, secured	 säkra, säkrade, säkrat	V
security protocol, security protocols	säkerhetsprotokoll, säkerhetsprotokollet, säkerhetsprotokoll	N
security, securities	säkerhet, säkerheten, säkerheter	N
segmentation, segmentations	segmentering, segmenteringen, segmenteringar	N
select, selected, selected	 välja, valde, valt	V
selection sort, selection sorts	urvalssortering, urvalssorteringen, urvalssorteringar	N
selection, selections	urval, urvalet, urval	N
semantic	semantisk, semantiskt, semantiska	A
semantics, semantics	semantik, semantiken, semantiker	N
semaphore, semaphores	semafor, semaforen, semaforer	N
semiconductor, semiconductors	halvledare, halvledaren, halvledare	N
sense, sensed, sensed	 förstå, förstod, förstått	V
sense, senses	sinne, sinnet, sinnen	N
sensor, sensors	sensor, sensorn, sensorer	N
separate, separated, separated	 åtskilja, åtskilde, åtskilt	V
sequence, sequences	sekvens, sekvensen, sekvernser	N
sequential	sekventiell, sekventiellt, sekventiella	A
server, servers	server, servern, servrar	N
service, services	tjänst, tjänsten, tjänster	N
session, sessions	session, sessionen, sessioner	N
set theory, set theories	mängdteori, mängdteorin, mängteorier	N
set, set, set	 sätta, satte, satt	V
set, sets	uppsättning, uppsättningen, uppsättningar	N
setting, settings	inställning, inställningen, inställningar	N
shadow, shadows	skugga, skuggan, skuggor	N
share, shared, shared	 dela, delade, delat	V
shareware, sharewares	shareware, sharewareet, sharewares	N
sharing, sharings	fördelning, fördelningen, fördelningar	N
sheet, sheets	ark, arket, ark	N
shelf, shelfs	hylla, hyllan, hyllor	N
side, sides	sida, sidan, sidor	N
signal processing, signal processings	signalbehandling, signalbehandlingen, signalbehandlingar	N
signature, signatures	signatur, signaturen, signaturer	N
significant	viktig, viktigt, viktiga	A
silicon, silicons	silikon, silikonet, silikon	N
similar	liknande, liknande, liknande	A
simulate, simulated, simulated	 simulera, simulerade, simulerat	V
simulation method, simulation methods	simuleringsmetod, simuleringsmetoden, simuleringsmetoder	N
simulation, simulations	simulering, simuleringen, simuleringar	N
singleton, singletons	singleton, singeltonen, singeltons	N
site, sites	sajt, sajten, sajter	N
skill, skills	färdighet, färdigheten, färdigheter	N
software architecture, software architectures	mjukvaruarkitektur, mjukvaruarkitekturen, mjukvaruarkitekturer	N
software deployment, software deployments	mjukvaruimplementering, mjukvaruimplementeringen, mjukvaruimplementeringar	N
software development assignment, software development assignments	mjukvaruutvecklingsuppgift, mjukvaruutvecklingsuppgiften, mjukvaruutvecklingsuppgifter	N
software development process, software development processes	mjukvaruutvecklingsprocess, mjukvaruutvecklingsprocessen, mjukvaruutvecklingsprocesser	N
software development project, software development projects	mjukvaruutvecklingsprojekt, mjukvaruutvecklingsprojektet, mjukvaruutvecklingsprojekt	N
software development, software developments	mjukvaruutveckling, mjukvaruutvecklingen, mjukvaruutvecklingar	N
software engineer, software engineers	mjukvaruingenjör, mjukvaruingenjören, mjukvaruingenjörer	N
software system, software systems	mjukvarusystem, mjukvarusystemet, mjukvarusystem	N
software technology, software technologies	programvaruteknik, programvarutekniken, programvarutekniker	N
software tool, software tools	programmeringsverktyg, programmeringsverktyget, programmeringsverktyg	N
software, softwares	programvara, programvaran, programvaror	N
solid	solid, solitt, solida	A
solution, solutions	lösning, lösningen, lösningar	N
solve, solved, solved	 lösa, löste, löst	V
sort, sorted, sorted	 sortera, sorterade, sorterat	V
sorting algorithm, sorting algorithms	sorteringsalgoritm, sorteringsalgoritmen, sorteringsalgoritmer	N
sound card, sound cards	ljudkort, ljudkortet, ljudkort	N
sound, sounded, sounded	 ljuda, ljöd, ljudit	V
sound, sounds	ljud, ljudet, ljud	N
source code, source codes	källkod, källkoden, källkodar	N
source, sources	källa, källan, källor	N
space, spaced, spaced	 fördela, fördelade, fördelat	V
space, spaces	plats, platsen, platser	N
spam, spams	skräppost, skräpposten, skräpposter	N
special	särskild, särskilt, särskilda	A
specific	specifik, specifikt, specifika	A
specification, specifications	specifikation, specifikationen, specifikationer	N
specify, specified, specified	 specifiera, specifierade, specifierat	V
spectrum, spectrums	spektrum, spektrumet, spektra	N
speculation, speculations	spekulering, spekuleringen, spekuleringar	N
speech recognition, speech recognitions	taligenkänning, taligenkänningen, taligenkänningar	N
speed, speeds	hastighet, hastigheten, hastigheter	N
spline, splines	lister, listret, lister	N
spreadsheet, spreadsheets	kalkylark, kalkylarket, kalkylark	N
square, squares	kvadrat, kvadraten, kvadrater	N
stack, stacks	stack, stacken, stackar	N
standard algorithm, standard algorithms	standardalgoritm, standardalgoritmen, standardalgoritmer	N
standard class, standard classes	standardklass, standardklassen, standardklasser	N
standard library, standard libraries	standardbibliotek, standardbiblioteket, standardbibliotek	N
standard, standards	standard, standarden, standarder	N
start, started, started	 börja, började, börjat	V
state, stated, stated	 konstatera, konstaterade, konstaterat	V
state, states	tillstånd, tillståndet, tillstånd	N
statement, statements	sats, satsen, satser	N
static	statisk, statiskt, statiska	A
static memory, static memories	statiskt minne, statiska minnet, statiska minnen	N
static random-access memory, static random-access memories	statiskt minne, statiska minnet, statiska minnen	N
statistical	statistisk, statistiskt, statistiska	A
statistics, statistics	statistik, statistiken, statistiker	N
stereo, stereos	stereo, stereon, stereor	N
storage techniques, storage techniqueses	lagringsteknik, lagringstekniken, lagringstekniker	N
storage, storages	lagring, lagringen, lagringar	N
store, stored, stored	 lagra, lagrade, lagrat	V
storm, stormed, stormed	 storma, stormade, stormat	V
storm, storms	storm, stormen, stormar	N
strategy, strategys	strategi, strategin, strategier	N
stream, streamed, streamed	 strömma, strömmade, strömmat	V
stream, streams	ström, strömmen, strömmar	N
strict	strikt, strikt, strikta	A
string, strings	sträng, strängen, strängar	N
structure, structured, structured	 strukturera, strukturerade, strukturerat	V
structure, structures	struktur, strukturen, strukturer	N
student, students	student, studenten, studenter	N
study, studied, studied	 studera, studerade, studerat	V
style, styles	stil, stilen, stilar	N
subclass, subclasss	subklass, subklassen, subklasser	N
subjunctive, subjunctives	konjunktiv, konjunktivet, konjunktiv	N
submission, submissions	inlämning, inlämningen, inlämningar	N
subroutine, subroutines	subrutin, subrutinen, subrutiner	N
subscriber, subscribers	prenumerant, prenumeranten, prenumeranter	N
subset, subsets	delmängd, delmängden, delmängder	N
subsystem, subsystems	subsystem, subsystemet, subsystem	N
suite, suites	svit, sviten, sviter	N
summarize, summarized, summarized	 summera, summerade, summerat	V
superclass, superclasss	superklass, superklassen, superklasser	N
supercomputer, supercomputers	superdator, superdatorn, superdatorer	N
supervision, supervisions	handledning, handledningen, handledningar	N
support, supported, supported	 stödja, stödde, stött	V
support, supports	stöd, stödet, stöd	N
sustainability, sustainabilities	hållbarhet, hållbarheten, hållbarheter	N
sustainable	hållbar, hållbart, hållbara	A
switch, switched, switched	 switcha, switchade, switchat	V
switch, switches	strömbrytare, strömbrytaren, strömbrytare	N
symbol, symbols	symbol, symbolen, symboler	N
symmetric	symmetrisk, symmetriskt, symmetriska	A
synchronization error, synchronization errors	synkroniseringsfel, synkroniseringsfelet, synkroniseringsfel	N
synchronization, synchronizations	synkronisering, synkroniseringen, synkroniseringar	N
syntax analysis, syntax analyses	syntaxanalys, syntaxanalysen, syntaxanalyser	N
syntax, syntaxes	syntax, syntaxen, syntaxer	N
system requirement, system requirements	systemkrav, systemkravet, systemkrav	N
system specification, system specifications	systemspecifikation, systemspecifikationen, systemspecifikationer	N
system verification, system verifications	systemverifiering, systemverifieringen, systemverifieringar	N
system, systems	system, systemet, system	N
systematic	systematisk, systematiskt, systematiska	A
table, tables	tabell, tabellen, tabeller	N
tag, tags	tagg, taggen, taggar	N
tape drive, tape drives	bandstation, bandstationen, bandstationer	N
tape, taped, taped	 banda, bandade, bandat	V
task, tasks	arbetsuppgift, arbetsuppgiften, arbetsuppgifter	N
taskbar, taskbars	aktivitetsfält, aktivitetsfältet, aktivitetsfält	N
teach, taught, taught	 undervisa, undervisade, undervisat	V
team, teams	lag, laget, lag	N
technical	teknisk, tekniskt, tekniska	A
technique, techniques	teknik, tekniken, tekniker	N
technological	teknologisk, teknologiskt, teknologiska	A
technology, technologies	teknologi, teknologin, teknologier	N
telecommunication, telecommunications	telekommunikation, telekommunikationen, telekommunikationer	N
telecommunications, telecommunicationses	telekommunikation, telekommunikationen, telekommunikationer	N
telephony, telephonies	telefoni, telefonin, telefonier	N
template, templates	mall, mallen, mallar	N
temporal	temporal, temporalt, temporala	A
terabyte, terabytes	terabyte, terabyten, terabyte	N
term, terms	term, termen, termer	N
terminal	terminal, terminalt, terminala	A
terminal, terminals	terminal, terminalen, terminaler	N
terminator, terminators	terminator, terminatorn, terminatorer	N
terminology, terminologies	terminologi, terminologin, terminologier	N
test, tested, tested	 testa, testade, testat	V
test, tests	test, testet, tester	N
text editor, text editors	textredigerare, textredigeraren, textredigerare	N
text, texts	text, texten, texter	N
theorem, theorems	sats, satsen, satser	N
theoretical	teoretisk, teoretiskt, teoretiska	A
theory, theories	teori, teorin, teorier	N
thesis, theses	tes, tesen, teser	N
thread, threads	tråd, tråden, trådar	N
throughput, throughputs	genomströmning, genomströmningen, genomströmningar	N
time complexity, time complexities	tidskomplexitet, tidskomplexiteten, tidskomplexiteter	N
time, timed, timed	 tajma, tajmade, tajmat	V
time, times	tid, tiden, tider	N
token, tokens	token, tokenet, tokens	N
tolerance, tolerances	tolerans, toleransen, toleranser	N
tool, tools	verktyg, verktyget, verktyg	N
toolbox, toolboxes	verktygslåda, verktygslådan, verktygslådor	N
topic, topics	ämne, ämnet, ämnen	N
topology, topologies	topologi, topologin, topologier	N
touchscreen, touchscreens	pekskärm, pekskärmen, pekskärmar	N
trace, traced, traced	 spåra, spårade, spårat	V
trackpad, trackpads	styrplatta, styrplattan, styrplattor	N
transaction, transactions	transaktion, transaktionen, transaktioner	N
transfer, transferred, transferred	 överföra, överförde, överfört	V
transfer, transfers	omplacering, omplaceringen, omplaceringar	N
transform, transformed, transformed	 omvandla, omvandlade, omvandlat	V
transformation, transformations	omvandling, omvandlingen, omvandlingar	N
transformer, transformers	transformator, transformatorn, transformatorer	N
transistor, transistors	transistor, transistorn, transistorer	N
translation, translations	översättning, översättningen, översättningar	N
translator, translators	översättare, översättaren, översättare	N
transmission, transmissions	överföring, överföringen, överföringar	N
transportation, transportations	transportering, transporteringen, transporteringar	N
tree, trees	träd, trädet, träd	N
triton, tritons	triton, tritonet, triton	N
true	sann, sant, sanna	A
truth value, truth values	sanningsvärde, sanningsvärdet, sanningsvärden	N
tube, tubes	tub, tuben, tuber	N
two-factor authentication, two-factor authentications	tvåfaktorautentisering, tvåfaktorautentiseringen, tvåfaktorautentiseringar	N
type, typed, typed	 skriva, skrev, skrivit	V
type, typed, typed	 typa, typade, typat	V
type, types	typ, typen, typer	N
unauthorized access, unauthorized accesses	obehörig åtkomst, obehöriga åtkomsten, obehöriga åtkomstar	N
uncertainty, uncertainties	osäkerhet, osäkerheten, osäkerhetar	N
underlying	underliggande, underliggande, underliggande	A
unification, unifications	unifiering, unifieringen, unifieringar	N
uniform	enhetlig, enhetligt, enhetliga	A
uniform, uniforms	uniform, uniformen, uniformer	N
unify, unified, unified	 förena, förenade, förenat	V
union, unions	union, unionen, unioner	N
unique	unik, unikt, unika	A
unique key, unique keys	databasnyckel, databasnyckeln, databasmycklar	N
unit, units	enhet, enheten, enheter	N
universal	allmän, allmänt, allmänna	A
university, universities	universitet, universitetet, universitet	N
unreliable	opålitlig, opålitligt, opålitliga	A
update, updated, updated	 uppdatera, uppdaterade, uppdaterat	V
update, updates	uppdatering, uppdateringen, uppdateringar	N
use case, use cases	användningsfall, användningsfallet, användningsfall	N
use, used, used	 använda, använde, använt	V
user agent, user agents	användaragent, användaragenten, avändaragenter	N
user experience, user experiences	användarupplevelse, användarupplevelsen, användarupplevelser	N
user group, user groups	användargrupp, användargruppen, användargrupper	N
user interface, user interfaces	användargränssnitt, användargränssnittet, användargränssnitt	N
user test, user tests	användartest, användartestet, användartester	N
user, users	användare, användaren, användare	N
utility, utilities	verktyg, verktyget, verktyg	N
validation, validations	validering, valideringen, valideringar	N
value, valued, valued	 värdera, värderade, värderat	V
value, values	värde, värdet, värden	N
variable, variables	variabel, variabeln, variabler	N
variance, variances	varians, variansen, varianser	N
vary, varied, varied	 variera, varierade, varierat	V
vector, vectors	vektor, vektorn, vektorer	N
vehicle, vehicles	fordon, fordonet, fordon	N
verification, verifications	verifiering, verifieringen, verifieringar	N
verify, verified, verified	 verifiera, verifierade, verifierat	V
versatile	allsidig, allsidigt, allsidiga	A
version control system, version control systems	versionshanteringssystem, versionshanteringssystemet, versionshanteringssystem	N
version control, version controls	versionshantering, versionshanteringen, versionshanteringar	N
version, versions	version, versionen, versioner	N
video card, video cards	grafikkort, grafikkortet, grafikkort	N
video, videos	video, videon, videor	N
virtual	virtuell, virtuellt, virtuella	A
virtual private network, virtual private networks	virtuellt privat nätverk, virtuella privata nätverket, virtuella privata nätverk	N
virus, viruses	virus, viruset, virus	N
visual	visuell, visuellt, visuella	A
visualization, visualizations	visualisering, visualiseringen, visualiseringar	N
voice, voices	ljud, ljudet, ljud	N
voice, voices	röst, rösten, röster	N
volatile	labil, labilt, labila	A
voltage, voltages	spänning, spänningen, spänningar	N
volume, volumes	volym, volymen, volymer	N
vulnerability, vulnerabilities	sårbarhet, sårbarheten, sårbarheter	N
warehouse, warehouses	lager, lagret, lager	N
waterfall model, waterfall models	vattenfallsmodell, vattenfallsmodellen, vattenfallsmodeller	N
web application, web applications	webbapplikation, webbapplikationen, webbapplikationer	N
web browser, web browsers	webbläsare, webbläsaren, webbläsare	N
web page, web pages	webbsida, webbsidan, webbsidor	N
web server, web servers	webbserver, webbservern, webbservrar	N
webcam, webcams	webbkamera, webbkameran, webbkameror	N
website, websites	webbsida, webbsidan, webbsidor	N
well-grounded	välgrundad, välgrundat, välgrundade	A
while-loop, while-loops	while-loop, while-loopen, while-loopar	N
while-statement, while-statements	while-sats, while-satsen, while-satser	N
whitelist, whitelists	vitlista, vitlistan, vitlistor	N
window, windows	fönster, fönstret, fönster	N
wireless	trådlös, trådlöst, trådlösa	A
word processor, word processors	ordbehandlare, ordbehandlaren, ordbehandlare	N
word, worded, worded	 uttrycka, uttryckte, uttryckt	V
work, works	arbete, arbetet, arbeten	N
world, worlds	värld, världen, världar	N
worldwide	global, globalt, globala	A
write, wrote, written	 skriva, skrev, skrivit	V
